0000020000000000000000000000000000000000000000000000000
0111111111111111111111111111111111111111000000000000000
0100000000000000010100000000000000000010000000000001000
0111101111111111110111000000000000000010000000001111000
0100101000100000100001011110000000000110000000001000000
0110001000001111100001110011111111111100000000001000000
0010001111100001000001000000000000000000000000011000000
0011100000100111000111000000000000000000000000010000000
0000100000100000000100000000000000000000000000011100000
0000111001100000000111111111111111111111111100000100000
0000100001000000000000000000000000000000000111111100000
0000000001100000000000000000000000000000000000000000000
0000000000300000000000000000000000000000000000000000000