0000020000000000000
0111111111111111110
0100000000000000010
0111101111111111110
0100101000100000100
0110001000001111100
0010001111100001000
0011100000100111000
0000100000100000000
0000111001100000000
0000100001000000000
0000000001100000000
0000000000300000000